           **    *     *  * * **  *       **   *  ** *  ** *** * *   * *    *** 
  *** **  * ****      ***   **  *      *****     *     ***      ** * *   *  *   
  *** *      **  *  *       *    **  **  *  **    * *    * **   *     *   *  *  
*  * ***          * **       *         * *               **  *    *     **   *  
 *      *                 *  *  *  **    *  *     * *  * * * ** *  *    *     * 
    *    *   **  * ** *     **    * ** **      **  **** ** * *  *  **    *  * **
  *         *** *     *     *   *   * ** ** *   *     * *   * *  **    * * **   
 **     *         *     *       *  * **  *            *  * **  *               *
    * *   *         * *** **        ** *     *  * ** *       *   **  *          
    *     **       *  * *       *         *  *  *  *   **      **      **     * 
**  *** *       * *** *    * *         *    **       *        * *    * ***     *
   ** ** ** *  *        **    ** ***   *       * *    **        *  * ** ***  ***
*  *  * *     *         *        ****  *        **      * ***++++++       *     
  *** * *    *    * *    *  *  *  * *  *  **** *    *+++++  *+** *+++* * ****  *
  **  *  *****    **  * **  ****    ***   *   ***  **+*  +++++ *  **+   * *     
  * **          *   *       **  ** **       *    *** +** *     **  *G *  *      
          *   * *  * *    **    **** *   **        **++** * *   **     * ** *   
   **      **** *  *    *   *    ** *     *  ** *  *  + *  * *    * **    *    *
***    *  *  **  **      * *  **** * **    *      *** +*    * *    *            
   **       * * *  * * *    * ** *  *      * *  *  * *+I     * **     * *  * * *
  **        *    ****       *      *    **  *  * * *  * *   ** **  * **   **  * 
 * ***   *        * ** **  *       *   * **  ***    **  * *     *   **** ** *   
       ** *            *    *     *  *    **  **  *   *  **     **  **  ***    *
*  ***  *  * * * *    * * **    ***     * * *  *  * *  * *    *   * *  ***** *  
**  **  *    *                 * ****  *        *      *  **       **  *        
  *      *  ***           **  *   * **   *   * *   *     * **  **         **    
  *         *   ** *  * *            ***  *  *     *            *    * * * *   *
   ** * * **   *  *   ***** *   *      *  * *  *  **        * * *    *      *   
    *    ***       ****   *** *    *       *   * *    *     * * *  ** **      * 
    **      **   **    * **     ** ***        *    ** *    **     *   *    *    
 ** **   * *     *  *   **  *   * **      *  **     ** * *       *      **   *  
*   **  **     *    * *      *    *       *     *   *    *   ***  *     *  * ***
   ** * * * *  * *     *  **          **            *            * *       * *  
 * ** * *   * *  * * *  *       *     **  *        * * **   *  *  **   * *  *   
*  ***      *       * *  *   *  **    **  *   **        * *  *  *  *    * *** * 
    **  **        *  **  *    *       *  ***           *    *** *    *****     *
 ***  *  *  ** ** * **       * *     *   *  ** *   * * *  * *        * **       
   *      *   *    * *      * * **  ****  *    *       * **  ***   **   *   ** *
     *   ***   *  *   *  **     **              *  **   ** *** *   *  *  *      
  **           **          * *** * *  **    * * *    *      *  *    *  *  * * * 
     *       ** *     * *   *   ** *    *  *    * *  *  ** ** * **  *  * *  *  *
         *   * ***  * ***        *       * *         *  *    *  ****       *    
  *  * *     ** *          * *    *       * * ** * **   *      **   ** *** **   
*  *   *   * *  *    *   *   ***            * *         *  *     **      *  * * 
*  *      *        ** * *  * *   *     *     ** *       **     *    **    *     
 * *  *        ***     *  *  **  *  *** *  *  *   ** *   ***** **  * *     ***  
      * *        *    *  *    *  *   **      *  *    *   *  **   *   **** *    *
     * *     *     *       *         *      *     *   **     *  **  **   *   *  
    **   **                 **  *    * ** *    *  **  *  *     * * *     * **   
 *  *  ***  *  **  *       ** *   *    **   **     * * *       *       **   **  
         **   * * ***      *         *  * **    **   **  * * * * *      * *     
     *   * **   *  *  *      * *    ** **     **     **   ** * *   * *     *    
   **    * *  * *   * *  *  *  *   *   * ** *   * **      ***    **       *   **
 * *   *  *       * *  *    *     * **    *  *  *  *  *  *   *     *         * *
           ** **   **          *    *  *     * *  *     **     *             ** 
   *  ** *     *  * * *      *        ** * *  *    *   * *  * *  * **   *  **   
*        **     ** * *     * *      *  ** **  *           *  *   *      *   **  
 **    **       **  *  *   *    * ** ** *   *  *     ** *  *     *  *   *** *   
* **   * *   *  * **        *   *        *  * * *     *      *  *    *          
 *      * *  * **   *    *     ** *    *          *    * *  ***       *   * *   

